00,00,00,00,00,00,00,00,00,00,00,00,00,00,00,00,00,00,00,00,00,00,00,00,00,00,00,00,00,00,00,00
00,00,00,00,00,00,00,00,00,00,00,00,00,00,00,00,00,00,00,00,00,00,00,00,00,00,00,00,00,00,00,00
00,00,00,00,00,00,00,00,00,00,00,00,00,00,00,00,00,00,00,00,00,00,00,00,00,00,00,00,00,00,00,00
00,00,00,04,04,04,04,04,04,04,04,04,04,04,04,04,04,04,04,04,04,04,04,00,00,00,00,00,00,00,00,00
00,00,00,04,11,11,11,11,11,11,11,11,11,11,11,11,11,11,11,11,11,11,04,00,00,00,00,00,00,00,00,00
00,00,00,04,11,11,11,11,11,11,11,11,11,11,11,11,11,11,11,11,11,11,04,00,00,00,00,00,00,00,00,00
00,00,00,04,11,11,11,04,04,04,04,04,11,11,11,11,11,11,11,11,11,11,04,00,00,00,00,00,00,00,00,00
00,00,00,04,11,11,11,04,11,11,11,11,11,11,11,11,11,11,11,11,11,11,04,00,00,00,00,00,00,00,00,00
00,00,00,04,11,11,11,04,11,11,11,11,11,11,11,11,11,11,11,11,11,11,04,00,00,00,00,00,00,00,00,00
00,00,00,04,11,11,11,04,11,11,11,11,04,11,11,11,11,11,11,11,11,11,04,00,00,00,00,00,00,00,00,00
00,00,00,04,04,04,04,04,04,04,04,04,04,11,11,11,11,11,11,11,11,11,04,00,00,00,00,00,00,00,00,00
00,00,00,00,00,00,00,00,00,00,00,00,04,11,11,11,11,11,11,11,11,11,04,04,04,04,04,04,04,04,04,00
00,00,00,04,04,04,04,04,04,04,00,00,04,11,11,11,11,11,11,11,11,11,11,11,11,11,11,11,11,11,04,00
00,00,04,11,11,11,11,11,11,11,04,00,04,11,11,11,11,11,11,11,11,11,11,11,11,11,11,11,11,11,04,00
00,00,04,11,11,11,11,11,11,11,04,00,04,11,11,11,11,11,11,11,11,11,11,11,11,11,11,11,11,11,04,00
00,00,04,11,11,11,11,11,11,11,04,00,04,11,11,11,11,11,11,11,11,04,11,11,11,11,11,11,11,11,04,00
00,00,04,11,11,11,11,11,11,11,04,00,04,11,11,11,11,11,11,11,11,04,11,11,11,11,11,11,11,11,04,00
00,00,04,11,11,11,11,11,11,11,04,00,04,11,11,11,11,11,11,11,11,04,11,11,11,11,11,11,11,11,04,00
00,00,04,11,11,11,11,11,11,11,04,00,00,04,04,11,11,11,11,11,11,04,11,11,11,11,11,11,11,11,04,00
00,00,04,11,11,11,11,11,11,11,04,00,00,00,04,11,11,11,11,11,11,04,04,11,11,11,11,11,11,11,04,00
00,00,04,11,11,11,11,11,11,11,04,04,04,04,04,11,11,11,11,11,11,04,04,04,04,11,04,04,04,04,04,00
00,00,04,11,11,11,11,11,11,11,11,11,11,11,11,11,11,11,11,11,11,04,00,00,04,04,04,00,00,00,00,00
00,00,04,11,11,11,11,11,11,11,11,11,11,11,11,11,11,11,11,11,11,04,00,00,00,00,00,00,00,00,00,00
00,00,04,11,11,11,11,11,11,11,11,11,11,11,11,11,11,11,11,11,11,04,00,00,00,00,00,00,00,00,00,00
00,00,04,11,11,11,11,11,11,11,11,04,04,04,04,04,04,11,11,11,11,04,00,00,00,00,00,00,00,00,00,00
00,00,04,11,11,11,11,11,11,11,11,04,01,01,01,01,04,06,06,06,06,04,01,01,01,01,00,00,00,00,00,00
00,00,04,11,11,11,11,11,11,11,11,04,01,01,01,05,04,05,06,06,06,05,05,02,02,01,01,00,00,00,00,00
00,00,04,11,11,11,11,11,11,11,11,04,01,01,01,05,05,05,05,05,05,05,05,05,02,02,01,00,03,00,00,00
00,00,04,11,11,11,11,11,11,11,11,04,01,01,05,05,05,05,05,05,05,05,05,02,02,02,01,03,03,03,03,00
00,00,00,04,04,04,04,04,04,04,04,00,01,01,02,02,02,02,02,02,02,02,02,02,02,01,01,03,03,03,03,00
00,00,00,00,00,00,00,00,00,00,00,00,01,01,01,01,01,01,01,01,01,01,01,01,01,01,01,00,03,00,00,00
00,00,00,00,00,00,00,00,00,00,00,00,00,01,01,01,01,01,01,01,01,01,01,01,01,01,01,00,00,00,00,00

0,0,0,0,0,0,0,0,0,0,0,0,0,0,0,0,0,0,0,0,0,0,0,0,0,0,0,0,0,0,0,0
0,0,0,0,0,0,0,0,0,0,0,0,0,0,0,0,0,0,0,0,0,0,0,0,0,0,0,0,0,0,0,0
0,0,0,0,0,0,0,0,0,0,0,0,0,0,0,0,0,0,0,0,0,0,0,0,0,0,0,0,0,0,0,0
0,0,0,1,1,1,1,1,1,1,1,1,1,1,1,1,1,1,1,1,1,1,1,0,0,0,0,0,0,0,0,0
0,0,0,1,0,0,0,0,0,0,0,0,0,0,0,0,0,0,0,0,0,0,1,0,0,0,0,0,0,0,0,0
0,0,0,1,0,0,0,0,0,0,0,0,0,0,0,0,0,0,0,0,0,0,1,0,0,0,0,0,0,0,0,0
0,0,0,1,0,0,0,1,1,1,1,1,0,0,0,0,0,0,0,0,0,0,1,0,0,0,0,0,0,0,0,0
0,0,0,1,0,0,0,1,0,0,0,0,0,0,0,0,0,0,0,0,0,0,1,0,0,0,0,0,0,0,0,0
0,0,0,1,0,0,0,1,0,0,0,0,0,0,0,0,0,0,0,0,0,0,1,0,0,0,0,0,0,0,0,0
0,0,0,1,0,0,0,1,0,0,0,0,1,0,0,0,0,0,0,0,0,0,1,0,0,0,0,0,0,0,0,0
0,0,0,1,1,1,1,1,1,1,1,1,1,0,0,0,0,0,0,0,0,0,1,0,0,0,0,0,0,0,0,0
0,0,0,0,0,0,0,0,0,0,0,0,1,0,0,0,0,0,0,0,0,0,1,1,1,1,1,1,1,1,1,0
0,0,0,1,1,1,1,1,1,1,0,0,1,0,0,0,0,0,0,0,0,0,0,0,0,0,0,0,0,0,1,0
0,0,1,0,0,0,0,0,0,0,1,0,1,0,0,0,0,0,0,0,0,0,0,0,0,0,0,0,0,0,1,0
0,0,1,0,0,0,0,0,0,0,1,0,1,0,0,0,0,0,0,0,0,0,0,0,0,0,0,0,0,0,1,0
0,0,1,0,0,0,0,0,0,0,1,0,1,0,0,0,0,0,0,0,0,1,0,0,0,0,0,0,0,0,1,0
0,0,1,0,0,0,0,0,0,0,1,0,1,0,0,0,0,0,0,0,0,1,0,0,0,0,0,0,0,0,1,0
0,0,1,0,0,0,0,0,0,0,1,0,1,0,0,0,0,0,0,0,0,1,0,0,0,0,0,0,0,0,1,0
0,0,1,0,0,0,0,0,0,0,1,0,0,1,1,0,0,0,0,0,0,1,0,0,0,0,0,0,0,0,1,0
0,0,1,0,0,0,0,0,0,0,1,0,0,0,1,0,0,0,0,0,0,1,1,0,0,0,0,0,0,0,1,0
0,0,1,0,0,0,0,0,0,0,1,1,1,1,1,0,0,0,0,0,0,1,1,1,1,0,1,1,1,1,1,0
0,0,1,0,0,0,0,0,0,0,0,0,0,0,0,0,0,0,0,0,0,1,0,0,1,1,1,0,0,0,0,0
0,0,1,0,0,0,0,0,0,0,0,0,0,0,0,0,0,0,0,0,0,1,0,0,0,0,0,0,0,0,0,0
0,0,1,0,0,0,0,0,0,0,0,0,0,0,0,0,0,0,0,0,0,1,0,0,0,0,0,0,0,0,0,0
0,0,1,0,0,0,0,0,0,0,0,1,1,1,1,1,1,0,0,0,0,1,1,1,1,1,1,0,0,0,0,0
0,0,1,0,0,0,0,0,0,0,0,1,0,0,0,0,1,0,0,0,0,1,0,0,0,0,1,1,0,0,0,0
0,0,1,0,0,0,0,0,0,0,0,1,0,0,0,0,1,0,0,0,0,0,0,0,0,0,0,1,1,1,0,0
0,0,1,0,0,0,0,0,0,0,0,1,0,0,0,0,0,0,0,0,0,0,0,0,0,0,0,1,0,1,1,1
0,0,1,0,0,0,0,0,0,0,0,1,0,0,0,0,0,0,0,0,0,0,0,0,0,0,0,0,0,0,0,1
0,0,0,1,1,1,1,1,1,1,1,1,0,0,0,0,0,0,0,0,0,0,0,0,0,0,0,0,0,0,0,1
0,0,0,0,0,0,0,0,0,0,0,1,0,0,0,0,0,0,0,0,0,0,0,0,0,0,0,1,0,1,1,1
0,0,0,0,0,0,0,0,0,0,0,1,1,1,1,1,1,1,1,1,1,1,1,1,1,1,1,1,1,1,0,0
